[
  [0,0,0,0,0,0,0,0,0,0],
  [0,3,3,3,3,3,3,3,3,0],
  [0,3,2,2,2,2,2,2,3,0],
  [0,3,2,1,1,1,1,2,3,0],
  [0,3,2,1,9,9,1,2,3,0],
  [0,3,2,1,9,9,1,2,3,0],
  [0,3,2,1,1,1,1,2,3,0],
  [0,3,2,2,2,2,2,2,3,0],
  [0,3,3,3,3,3,3,3,3,0],
  [0,0,0,0,0,0,0,0,0,0]
]
