[
  [0,0,0,0,0,0,0,0,0,0],
  [0,15,15,15,15,15,15,15,15,0],
  [0,16,16,16,16,16,16,16,16,0],
  [0,17,17,17,17,17,17,17,17,0],
  [0,0,0,0,9,9,0,0,0,0],
  [0,0,0,0,9,9,0,0,0,0],
  [0,1,1,1,1,1,1,1,1,0],
  [0,1,1,1,1,1,1,1,1,0],
  [0,0,0,0,0,0,0,0,0,0],
  [0,0,0,0,0,0,0,0,0,0]
]
