[
  [0,0,0,0,0,0,0,0,0,0],
  [10,10,10,10,10,10,10,10,10,10],
  [9,9,9,9,9,9,9,9,9,9],
  [0,0,0,0,0,0,0,0,0,0],
  [2,2,2,2,2,2,2,2,2,2],
  [9,9,9,9,9,9,9,9,9,9],
  [11,11,11,11,11,11,11,11,11,11],
  [0,0,0,0,0,0,0,0,0,0],
  [0,0,0,0,0,0,0,0,0,0],
  [0,0,0,0,0,0,0,0,0,0]
]
