[
  [0,0,0,0,0,0,0,0,0,0],
  [9,9,9,9,9,9,9,9,9,9],
  [9,2,2,2,2,2,2,2,2,9],
  [9,2,3,3,3,3,3,3,2,9],
  [9,2,3,9,1,1,9,3,2,9],
  [9,2,3,9,1,1,9,3,2,9],
  [9,2,3,3,3,3,3,3,2,9],
  [9,2,2,2,2,2,2,2,2,9],
  [9,9,9,9,1,1,9,9,9,9],
  [0,0,0,0,0,0,0,0,0,0]
]
