[
  [3,2,1,0,0,0,0,1,2,3],
  [2,1,0,0,0,0,0,0,1,2],
  [1,0,0,0,0,0,0,0,0,1],
  [0,0,0,0,0,0,0,0,0,0],
  [0,0,0,0,9,9,0,0,0,0],
  [0,0,0,0,9,9,0,0,0,0],
  [0,0,0,0,0,0,0,0,0,0],
  [1,0,0,0,0,0,0,0,0,1],
  [2,1,0,0,0,0,0,0,1,2],
  [3,2,1,0,0,0,0,1,2,3]
]
