[
  [9,9,9,9,9,9,9,9,9,9],
  [9,1,1,1,1,1,1,1,1,9],
  [9,1,2,2,2,2,2,2,1,9],
  [9,1,2,3,3,3,3,2,1,9],
  [9,1,2,3,0,0,3,2,1,9],
  [9,1,2,3,0,0,3,2,1,9],
  [9,1,2,3,3,3,3,2,1,9],
  [9,1,2,2,2,2,2,2,1,9],
  [9,1,1,1,1,1,1,1,1,9],
  [9,9,9,9,9,9,9,9,9,9]
]
